NO textures/mossy.xpm

SO ./textures/purplestone.xpm

S ./sprites/barrel.xpm
EA ./textures/redbrick.xpm

WE ./textures/wood.xpm


R 1900 1904
C 12,34,56
F 34,66,77

         
111111111111
1200000000001
1000000000001
1000000000001
100000S000001   111
1000000000001   101
1000000000001    1
1000000000001
1000000020001
1000100000001
1002000000001
1111101111111
1111101111111
110111
1111